"filename", "language", "Markdown", "JavaScript", "JSON", "HTML", "comment", "blank", "total"
"c:\Users\antka\OneDrive\Documents\Final Project\PeaceofMusic\README.md", "Markdown", 2, 0, 0, 0, 0, 1, 3
"c:\Users\antka\OneDrive\Documents\Final Project\PeaceofMusic\client\README.md", "Markdown", 38, 0, 0, 0, 0, 33, 71
"c:\Users\antka\OneDrive\Documents\Final Project\PeaceofMusic\client\package-lock.json", "JSON", 0, 0, 29090, 0, 0, 1, 29091
"c:\Users\antka\OneDrive\Documents\Final Project\PeaceofMusic\client\package.json", "JSON", 0, 0, 71, 0, 0, 1, 72
"c:\Users\antka\OneDrive\Documents\Final Project\PeaceofMusic\client\public\Comments\AddComment.js", "JavaScript", 0, 40, 0, 0, 0, 13, 53
"c:\Users\antka\OneDrive\Documents\Final Project\PeaceofMusic\client\public\Comments\CommentBtn.js", "JavaScript", 0, 7, 0, 0, 0, 2, 9
"c:\Users\antka\OneDrive\Documents\Final Project\PeaceofMusic\client\public\Comments\CommentContext.js", "JavaScript", 0, 22, 0, 0, 0, 9, 31
"c:\Users\antka\OneDrive\Documents\Final Project\PeaceofMusic\client\public\Comments\CommentFooter.js", "JavaScript", 0, 35, 0, 0, 0, 3, 38
"c:\Users\antka\OneDrive\Documents\Final Project\PeaceofMusic\client\public\Comments\CommentHeader.js", "JavaScript", 0, 19, 0, 0, 0, 2, 21
"c:\Users\antka\OneDrive\Documents\Final Project\PeaceofMusic\client\public\Comments\CommentSection.js", "JavaScript", 0, 107, 0, 0, 5, 16, 128
"c:\Users\antka\OneDrive\Documents\Final Project\PeaceofMusic\client\public\Comments\CommentVotes.js", "JavaScript", 0, 7, 0, 0, 0, 2, 9
"c:\Users\antka\OneDrive\Documents\Final Project\PeaceofMusic\client\public\Comments\DeleteModal.js", "JavaScript", 0, 7, 0, 0, 0, 2, 9
"c:\Users\antka\OneDrive\Documents\Final Project\PeaceofMusic\client\public\Comments\Reply.js", "JavaScript", 0, 7, 0, 0, 0, 2, 9
"c:\Users\antka\OneDrive\Documents\Final Project\PeaceofMusic\client\public\Comments\ReplyContainer.js", "JavaScript", 0, 7, 0, 0, 0, 2, 9
"c:\Users\antka\OneDrive\Documents\Final Project\PeaceofMusic\client\public\index.html", "HTML", 0, 0, 0, 26, 23, 2, 51
"c:\Users\antka\OneDrive\Documents\Final Project\PeaceofMusic\client\public\manifest.json", "JSON", 0, 0, 25, 0, 0, 1, 26
"c:\Users\antka\OneDrive\Documents\Final Project\PeaceofMusic\client\src\components\AddASong.js", "JavaScript", 0, 427, 0, 0, 9, 127, 563
"c:\Users\antka\OneDrive\Documents\Final Project\PeaceofMusic\client\src\components\App.js", "JavaScript", 0, 55, 0, 0, 0, 12, 67
"c:\Users\antka\OneDrive\Documents\Final Project\PeaceofMusic\client\src\components\ArtistCard.js", "JavaScript", 0, 66, 0, 0, 4, 20, 90
"c:\Users\antka\OneDrive\Documents\Final Project\PeaceofMusic\client\src\components\ArtistPage.js", "JavaScript", 0, 140, 0, 0, 0, 47, 187
"c:\Users\antka\OneDrive\Documents\Final Project\PeaceofMusic\client\src\components\Artists.js", "JavaScript", 0, 52, 0, 0, 0, 14, 66
"c:\Users\antka\OneDrive\Documents\Final Project\PeaceofMusic\client\src\components\Comments\Comment.js", "JavaScript", 0, 97, 0, 0, 0, 22, 119
"c:\Users\antka\OneDrive\Documents\Final Project\PeaceofMusic\client\src\components\Comments\CommentSection.js", "JavaScript", 0, 237, 0, 0, 10, 74, 321
"c:\Users\antka\OneDrive\Documents\Final Project\PeaceofMusic\client\src\components\CurrentUserContext.js", "JavaScript", 0, 67, 0, 0, 7, 21, 95
"c:\Users\antka\OneDrive\Documents\Final Project\PeaceofMusic\client\src\components\Diff.js", "JavaScript", 0, 35, 0, 0, 1, 8, 44
"c:\Users\antka\OneDrive\Documents\Final Project\PeaceofMusic\client\src\components\EditSongPage.js", "JavaScript", 0, 444, 0, 0, 28, 114, 586
"c:\Users\antka\OneDrive\Documents\Final Project\PeaceofMusic\client\src\components\EditsPage.js", "JavaScript", 0, 41, 0, 0, 0, 15, 56
"c:\Users\antka\OneDrive\Documents\Final Project\PeaceofMusic\client\src\components\ErrorPage.js", "JavaScript", 0, 7, 0, 0, 0, 2, 9
"c:\Users\antka\OneDrive\Documents\Final Project\PeaceofMusic\client\src\components\ForgivenessContext.js", "JavaScript", 0, 13, 0, 0, 1, 12, 26
"c:\Users\antka\OneDrive\Documents\Final Project\PeaceofMusic\client\src\components\GlobalStyles.js", "JavaScript", 0, 147, 0, 0, 1, 28, 176
"c:\Users\antka\OneDrive\Documents\Final Project\PeaceofMusic\client\src\components\Header.js", "JavaScript", 0, 151, 0, 0, 9, 55, 215
"c:\Users\antka\OneDrive\Documents\Final Project\PeaceofMusic\client\src\components\LandingPage.js", "JavaScript", 0, 74, 0, 0, 0, 16, 90
"c:\Users\antka\OneDrive\Documents\Final Project\PeaceofMusic\client\src\components\Layout.js", "JavaScript", 0, 12, 0, 0, 0, 4, 16
"c:\Users\antka\OneDrive\Documents\Final Project\PeaceofMusic\client\src\components\LoginButton.js", "JavaScript", 0, 24, 0, 0, 1, 7, 32
"c:\Users\antka\OneDrive\Documents\Final Project\PeaceofMusic\client\src\components\LogoutButton.js", "JavaScript", 0, 16, 0, 0, 1, 3, 20
"c:\Users\antka\OneDrive\Documents\Final Project\PeaceofMusic\client\src\components\MusicContext.js", "JavaScript", 0, 63, 0, 0, 2, 16, 81
"c:\Users\antka\OneDrive\Documents\Final Project\PeaceofMusic\client\src\components\PeaceContext.js", "JavaScript", 0, 66, 0, 0, 2, 25, 93
"c:\Users\antka\OneDrive\Documents\Final Project\PeaceofMusic\client\src\components\PeaceOfMusic.js", "JavaScript", 0, 435, 0, 0, 28, 132, 595
"c:\Users\antka\OneDrive\Documents\Final Project\PeaceofMusic\client\src\components\ProfileInfo.js", "JavaScript", 0, 517, 0, 0, 13, 110, 640
"c:\Users\antka\OneDrive\Documents\Final Project\PeaceofMusic\client\src\components\ProfilePage.js", "JavaScript", 0, 201, 0, 0, 9, 76, 286
"c:\Users\antka\OneDrive\Documents\Final Project\PeaceofMusic\client\src\components\SearchBar.js", "JavaScript", 0, 225, 0, 0, 29, 57, 311
"c:\Users\antka\OneDrive\Documents\Final Project\PeaceofMusic\client\src\components\SongCard.js", "JavaScript", 0, 36, 0, 0, 0, 11, 47
"c:\Users\antka\OneDrive\Documents\Final Project\PeaceofMusic\client\src\components\SongPage.js", "JavaScript", 0, 417, 0, 0, 14, 82, 513
"c:\Users\antka\OneDrive\Documents\Final Project\PeaceofMusic\client\src\components\SongPoms.js", "JavaScript", 0, 31, 0, 0, 0, 9, 40
"c:\Users\antka\OneDrive\Documents\Final Project\PeaceofMusic\client\src\components\Songs.js", "JavaScript", 0, 31, 0, 0, 0, 11, 42
"c:\Users\antka\OneDrive\Documents\Final Project\PeaceofMusic\client\src\components\SubHeader.js", "JavaScript", 0, 63, 0, 0, 1, 15, 79
"c:\Users\antka\OneDrive\Documents\Final Project\PeaceofMusic\client\src\components\SubmissionForm.js", "JavaScript", 0, 11, 0, 0, 0, 5, 16
"c:\Users\antka\OneDrive\Documents\Final Project\PeaceofMusic\client\src\components\TextEditor\PomEditor.js", "JavaScript", 0, 86, 0, 0, 0, 8, 94
"c:\Users\antka\OneDrive\Documents\Final Project\PeaceofMusic\client\src\components\TextEditor\ToolBar.js", "JavaScript", 0, 180, 0, 0, 0, 6, 186
"c:\Users\antka\OneDrive\Documents\Final Project\PeaceofMusic\client\src\components\UserPanel.js", "JavaScript", 0, 171, 0, 0, 2, 37, 210
"c:\Users\antka\OneDrive\Documents\Final Project\PeaceofMusic\client\src\components\YouTubePlayer.js", "JavaScript", 0, 16, 0, 0, 2, 10, 28
"c:\Users\antka\OneDrive\Documents\Final Project\PeaceofMusic\client\src\hooks\usePersistedState.js", "JavaScript", 0, 12, 0, 0, 0, 6, 18
"c:\Users\antka\OneDrive\Documents\Final Project\PeaceofMusic\client\src\index.js", "JavaScript", 0, 26, 0, 0, 2, 3, 31
"c:\Users\antka\OneDrive\Documents\Final Project\PeaceofMusic\package-lock.json", "JSON", 0, 0, 2246, 0, 0, 1, 2247
"c:\Users\antka\OneDrive\Documents\Final Project\PeaceofMusic\server\batchimport.js", "JavaScript", 0, 24, 0, 0, 4, 8, 36
"c:\Users\antka\OneDrive\Documents\Final Project\PeaceofMusic\server\data\adjectives.js", "JavaScript", 0, 379, 0, 0, 0, 1, 380
"c:\Users\antka\OneDrive\Documents\Final Project\PeaceofMusic\server\data\animals.js", "JavaScript", 0, 226, 0, 0, 0, 1, 227
"c:\Users\antka\OneDrive\Documents\Final Project\PeaceofMusic\server\data\profilepictures.js", "JavaScript", 0, 21, 0, 0, 0, 7, 28
"c:\Users\antka\OneDrive\Documents\Final Project\PeaceofMusic\server\handlers\chordhandlers.js", "JavaScript", 0, 26, 0, 0, 0, 7, 33
"c:\Users\antka\OneDrive\Documents\Final Project\PeaceofMusic\server\handlers\commenthandlers.js", "JavaScript", 0, 50, 0, 0, 1, 10, 61
"c:\Users\antka\OneDrive\Documents\Final Project\PeaceofMusic\server\handlers\musichandlers.js", "JavaScript", 0, 571, 0, 0, 23, 104, 698
"c:\Users\antka\OneDrive\Documents\Final Project\PeaceofMusic\server\handlers\userhandlers.js", "JavaScript", 0, 326, 0, 0, 4, 62, 392
"c:\Users\antka\OneDrive\Documents\Final Project\PeaceofMusic\server\index.js", "JavaScript", 0, 93, 0, 0, 8, 25, 126
"c:\Users\antka\OneDrive\Documents\Final Project\PeaceofMusic\server\package-lock.json", "JSON", 0, 0, 5386, 0, 0, 1, 5387
"c:\Users\antka\OneDrive\Documents\Final Project\PeaceofMusic\server\package.json", "JSON", 0, 0, 20, 0, 0, 1, 21
"c:\Users\antka\OneDrive\Documents\Final Project\PeaceofMusic\server\tempCodeRunnerFile.js", "JavaScript", 0, 1, 0, 0, 0, 0, 1
"Total", "-", 40, 6667, 36838, 26, 244, 1540, 45355